Absence	rev
Absent	rev
Ca N'T	rev
Ca n't	rev
Can Not	rev
Can not	rev
Could N'T	rev
Could Not	rev
Could n't	rev
Could not	rev
Denied	rev
Denies	rev
Deny	rev
Despite	rev
Did N'T	rev
Did Not	rev
Did n't	rev
Did not	rev
Do N'T	rev
Do Not	rev
Do n't	rev
Do not	rev
Does N'T	rev
Does Not	rev
Does n't	rev
Does not	rev
Either	rev
Except	rev
Excepted	rev
Excepting	rev
Excepts	rev
Exclude	rev
Excluded	rev
Excludes	rev
Excluding	rev
Fail	rev
Failed	rev
Failing	rev
Fails	rev
Failure	rev
Failures	rev
Fall	rev
Favor Over	rev
Favor over	rev
Had No	rev
Had no	rev
Have No	rev
Have no	rev
Impossible	rev
Inability	rev
Instead Of	rev
Instead of	rev
Is N'T	rev
Is Not	rev
Is n't	rev
Is not	rev
Lack	rev
Losses	rev
May Not	rev
May not	rev
Miss	rev
Missed	rev
Misses	rev
Missing	rev
Negative	rev
Neither	rev
Never	rev
No	rev
No Longer	rev
No longer	rev
Nobody	rev
None	rev
Nope	rev
Nor	rev
Not	rev
Not Very	rev
Not very	rev
Nothing	rev
Notwithstanding	rev
Nowhere	rev
Outweighed	rev
Rather Than	rev
Rather than	rev
Rejected	rev
Reversal	rev
Rule Out	rev
Rule out	rev
Unable	rev
Unauthorized	rev
Unavailable	rev
Unaware	rev
Was N'T	rev
Was No	rev
Was Not	rev
Was n't	rev
Was no	rev
Was not	rev
Will Not	rev
Will Not Be	rev
Will not	rev
Will not be	rev
With The Exception Of	rev
With the exception of	rev
Without	rev
Wo N'T Be	rev
Wo n't be	rev
Would Not	rev
Would Not Be	rev
Would not	rev
Would not be	rev
abeyance	unc
abeyances	unc
abovementioned	lit
abrogate	lit
abrogated	lit
abrogates	lit
abrogating	lit
abrogation	lit
abrogations	lit
absence	rev
absent	rev
absolve	lit
absolved	lit
absolves	lit
absolving	lit
accession	lit
accessions	lit
acquirees	lit
acquirors	lit
acquit	lit
acquits	lit
acquittal	lit
acquittals	lit
acquittance	lit
acquittances	lit
acquitted	lit
acquitting	lit
addendums	lit
adjourn	lit
adjourned	lit
adjourning	lit
adjournment	lit
adjournments	lit
adjourns	lit
adjudge	lit
adjudged	lit
adjudges	lit
adjudging	lit
adjudicate	lit
adjudicated	lit
adjudicates	lit
adjudicating	lit
adjudication	lit
adjudications	lit
adjudicative	lit
adjudicator	lit
adjudicators	lit
adjudicatory	lit
admissibility	lit
admissible	lit
admissibly	lit
admission	lit
admissions	lit
affidavit	lit
affidavits	lit
affirmance	lit
aforedescribed	lit
aforementioned	lit
aforesaid	lit
aforestated	lit
aggrieved	lit
allegation	lit
allegations	lit
allege	lit
alleged	lit
allegedly	lit
alleges	lit
alleging	lit
almost	mod
alteration	unc
alterations	unc
always	mod
ambiguities	unc
ambiguity	unc
ambiguous	unc
amend	lit
amendable	lit
amendatory	lit
amended	lit
amending	lit
amendment	lit
amendments	lit
amends	lit
anomalies	unc
anomalous	unc
anomalously	unc
anomaly	unc
antecedent	lit
antecedents	lit
anticipate	unc
anticipated	unc
anticipates	unc
anticipating	unc
anticipation	unc
anticipations	unc
antitrust	lit
anywise	lit
apparent	unc
apparently	mod
appeal	lit
appealable	lit
appealed	lit
appealing	lit
appeals	lit
appear	unc
appeared	mod
appearing	mod
appears	mod
appellant	lit
appellants	lit
appellate	lit
appellees	lit
appointor	lit
approximate	unc
approximated	unc
approximately	unc
approximates	unc
approximating	unc
approximation	unc
approximations	unc
appurtenance	lit
appurtenances	lit
appurtenant	lit
arbitrability	lit
arbitral	lit
arbitrarily	unc
arbitrariness	unc
arbitrary	unc
arbitrate	lit
arbitrated	lit
arbitrates	lit
arbitrating	lit
arbitration	lit
arbitrational	lit
arbitrations	lit
arbitrative	lit
arbitrator	lit
arbitrators	lit
arrearage	lit
arrearages	lit
ascendancy	lit
ascendant	lit
ascendants	lit
assertable	lit
assignation	lit
assignations	lit
assumable	lit
assume	unc
assumed	unc
assumes	unc
assuming	unc
assumption	unc
assumptions	unc
attest	lit
attestation	lit
attestations	lit
attested	lit
attesting	lit
attorn	lit
attorney	lit
attorneys	lit
attornment	lit
attorns	lit
avoided	rev
bail	lit
bailed	lit
bailee	lit
bailees	lit
bailiff	lit
bailiffs	lit
bailment	lit
barring	rev
believe	unc
believed	unc
believes	unc
believing	unc
beneficiation	lit
best	mod
bona	lit
bonafide	lit
breach	lit
breached	lit
breaches	lit
breaching	lit
ca n't	rev
can	mod
can not	rev
cautious	unc
cautiously	unc
cautiousness	unc
certiorari	lit
cession	lit
chattel	lit
chattels	lit
choate	lit
claim	lit
claimable	lit
claimant	lit
claimants	lit
claims	lit
clarification	unc
clarifications	unc
clearly	mod
codefendant	lit
codefendants	lit
codicil	lit
codicils	lit
codification	lit
codifications	lit
codified	lit
codifies	lit
codify	lit
codifying	lit
collusion	lit
compensatory	lit
complainant	lit
complainants	lit
conceivable	mod
conceivably	unc
condemnor	lit
conditional	unc
conditionally	unc
confiscatory	lit
confuses	unc
confusing	unc
confusingly	unc
confusion	unc
consent	lit
consented	lit
consenting	lit
consents	lit
conservatorships	lit
constitution	lit
constitutional	lit
constitutionality	lit
constitutionally	lit
constitutions	lit
constitutive	lit
contestation	lit
contingencies	unc
contingency	unc
contingent	unc
contingently	unc
contingents	unc
contract	lit
contracted	lit
contractholder	lit
contractholders	lit
contractible	lit
contractile	lit
contracting	lit
contracts	lit
contractual	lit
contractually	lit
contravene	lit
contravened	lit
contravenes	lit
contravening	lit
contravention	lit
contraventions	lit
controvert	lit
controverted	lit
controverting	lit
conveyance	lit
conveyances	lit
convict	lit
convicted	lit
convicting	lit
conviction	lit
convictions	lit
coterminous	lit
could	mod
could n't	rev
could not	rev
counsel	lit
counseled	lit
counselled	lit
counsels	lit
countersignor	lit
countersued	lit
countersuit	lit
court	lit
courtroom	lit
courts	lit
crime	lit
crimes	lit
criminal	lit
criminality	lit
criminally	lit
criminals	lit
crossclaim	lit
crossclaims	lit
crossroad	unc
crossroads	unc
decedent	lit
decedents	lit
declarant	lit
decree	lit
decreed	lit
decreeing	lit
decrees	lit
defalcation	lit
defalcations	lit
defeasance	lit
defeasances	lit
defease	lit
defeased	lit
defeasing	lit
defectively	lit
defendant	lit
defendants	lit
deference	lit
definitely	mod
definitively	mod
delegable	lit
delegatable	lit
delegatee	lit
delegees	lit
demurred	lit
demurrer	lit
demurrers	lit
demurring	lit
demurs	lit
denied	rev
denies	rev
deny	rev
depend	mod
depended	mod
dependence	unc
dependencies	unc
dependency	unc
dependent	unc
depending	mod
depends	mod
depose	lit
deposed	lit
deposes	lit
deposing	lit
deposition	lit
depositional	lit
depositions	lit
derogate	lit
derogated	lit
derogates	lit
derogating	lit
derogation	lit
derogations	lit
designator	lit
desist	lit
despite	rev
destabilizing	unc
detainer	lit
deviate	unc
deviated	unc
deviates	unc
deviating	unc
deviation	unc
deviations	unc
devisees	lit
did n't	rev
did not	rev
differ	unc
differed	unc
differing	unc
differs	unc
disaffiliation	lit
disaffirm	lit
disaffirmance	lit
disaffirmed	lit
disaffirms	lit
dispositive	lit
dispossession	lit
dispossessory	lit
distraint	lit
distributee	lit
distributees	lit
do n't	rev
do not	rev
docket	lit
docketed	lit
docketing	lit
dockets	lit
does n't	rev
does not	rev
donees	lit
doubt	unc
doubted	unc
doubtful	unc
doubts	unc
duly	lit
either	rev
ejectment	lit
encumber	lit
encumbered	lit
encumbering	lit
encumbers	lit
encumbrance	lit
encumbrancer	lit
encumbrancers	lit
encumbrances	lit
endorsee	lit
enforceability	lit
enforceable	lit
enforceably	lit
escheat	lit
escheated	lit
escheatment	lit
escrowing	lit
estoppel	lit
evidential	lit
evidentiary	lit
exceedance	lit
exceedances	lit
exceedences	lit
except	rev
excepted	rev
excepting	rev
excepts	rev
excised	lit
exclude	rev
excluded	rev
excludes	rev
excluding	rev
exculpate	lit
exculpated	lit
exculpates	lit
exculpating	lit
exculpation	lit
exculpations	lit
exculpatory	lit
executor	lit
executors	lit
executory	lit
executrices	lit
executrix	lit
executrixes	lit
exposure	unc
exposures	unc
extracontractual	lit
extracorporeal	lit
facie	lit
facto	lit
fail	rev
failed	rev
failing	rev
fails	rev
failure	rev
failures	rev
fall	rev
favor over	rev
felonies	lit
felonious	lit
felony	lit
fide	lit
fluctuate	unc
fluctuated	unc
fluctuates	unc
fluctuating	unc
fluctuation	unc
fluctuations	unc
forbade	lit
forbear	lit
forbearance	lit
forbearances	lit
forbearing	lit
forbears	lit
forebear	lit
forebearance	lit
forebears	lit
forfeitability	lit
forfeitable	lit
forthwith	lit
frequently	mod
fugitive	lit
fugitives	lit
furtherance	lit
generally	mod
grantor	lit
grantors	lit
had no	rev
have no	rev
henceforth	lit
henceforward	lit
hereafter	lit
hereby	lit
hereditaments	lit
herefor	lit
herefrom	lit
herein	lit
hereinabove	lit
hereinafter	lit
hereinbefore	lit
hereinbelow	lit
hereof	lit
hereon	lit
hereto	lit
heretofore	lit
hereunder	lit
hereunto	lit
hereupon	lit
herewith	lit
hidden	unc
highest	mod
hinges	unc
immateriality	lit
impleaded	lit
impossible	rev
imprecise	unc
imprecision	unc
imprecisions	unc
improbability	unc
improbable	unc
inability	rev
inasmuch	lit
incapacity	lit
incarcerate	lit
incarcerated	lit
incarcerates	lit
incarcerating	lit
incarceration	lit
incarcerations	lit
inchoate	lit
incompleteness	unc
incontestability	lit
incontestable	lit
indefinite	unc
indefinitely	unc
indefiniteness	unc
indemnifiable	lit
indemnification	lit
indemnifications	lit
indemnified	lit
indemnifies	lit
indemnify	lit
indemnifying	lit
indemnitee	lit
indemnitees	lit
indemnities	lit
indemnitor	lit
indemnitors	lit
indemnity	lit
indeterminable	unc
indeterminate	unc
indict	lit
indictable	lit
indicted	lit
indicting	lit
indictment	lit
indictments	lit
indorsees	lit
inexact	unc
inexactness	unc
inforce	lit
infraction	lit
infractions	lit
infringer	lit
injunction	lit
injunctions	lit
injunctive	lit
insofar	lit
instabilities	unc
instability	unc
instead of	rev
intangible	unc
intangibles	unc
interlocutory	lit
interpleader	lit
interpose	lit
interposed	lit
interposes	lit
interposing	lit
interposition	lit
interpositions	lit
interrogate	lit
interrogated	lit
interrogates	lit
interrogating	lit
interrogation	lit
interrogations	lit
interrogator	lit
interrogatories	lit
interrogators	lit
interrogatory	lit
intestacy	lit
intestate	lit
irrevocability	lit
irrevocable	lit
irrevocably	lit
is n't	rev
is not	rev
joinder	lit
judicial	lit
judicially	lit
judiciaries	lit
judiciary	lit
juries	lit
juris	lit
jurisdiction	lit
jurisdictional	lit
jurisdictionally	lit
jurisdictions	lit
jurisprudence	lit
jurist	lit
jurists	lit
juror	lit
jurors	lit
jury	lit
juryman	lit
justice	lit
justices	lit
lack	rev
law	lit
lawful	lit
lawfully	lit
lawfulness	lit
lawmakers	lit
lawmaking	lit
laws	lit
lawsuit	lit
lawsuits	lit
lawyer	lit
lawyers	lit
legal	lit
legalese	lit
legality	lit
legalization	lit
legalizations	lit
legalize	lit
legalized	lit
legalizes	lit
legalizing	lit
legally	lit
legals	lit
legatee	lit
legatees	lit
legislate	lit
legislated	lit
legislates	lit
legislating	lit
legislation	lit
legislations	lit
legislative	lit
legislatively	lit
legislator	lit
legislators	lit
legislature	lit
legislatures	lit
libel	lit
libeled	lit
libelous	lit
libels	lit
licensable	lit
lienholders	lit
likelihood	unc
likely	mod
litigant	lit
litigants	lit
litigate	lit
litigated	lit
litigates	lit
litigating	lit
litigation	lit
litigations	lit
litigator	lit
litigators	lit
litigious	lit
litigiousness	lit
losses	rev
lowest	mod
majeure	lit
mandamus	lit
may	mod
may not	rev
maybe	mod
mediate	lit
mediated	lit
mediates	lit
mediating	lit
mediation	lit
mediations	lit
mediator	lit
mediators	lit
might	mod
misdemeanor	lit
misfeasance	lit
miss	rev
missed	rev
misses	rev
missing	rev
mistrial	lit
mistrials	lit
moreover	lit
motions	lit
must	mod
mutandis	lit
nearly	mod
negative	rev
neither	rev
never	mod
never	rev
no	rev
no longer	rev
nobody	rev
nolo	lit
nonappealable	lit
nonassessable	unc
nonbreaching	lit
noncontingent	lit
noncontractual	lit
noncontributory	lit
none	rev
nonfeasance	lit
nonfiduciary	lit
nonforfeitability	lit
nonforfeitable	lit
nonforfeiture	lit
nonguarantor	lit
noninfringement	lit
noninfringing	lit
nonjudicial	lit
nonjudicially	lit
nonjurisdictional	lit
nonseverable	lit
nonterminable	lit
nonusurious	lit
nope	rev
nor	rev
not	rev
not very	rev
notarial	lit
notaries	lit
notarization	lit
notarizations	lit
notarize	lit
notarized	lit
notarizing	lit
notary	lit
nothing	rev
notwithstanding	lit
notwithstanding	rev
novo	lit
nowhere	rev
nullification	lit
nullifications	lit
nullified	lit
nullifies	lit
nullify	lit
nullifying	lit
nullities	lit
nullity	lit
obligee	lit
obligees	lit
obligor	lit
obligors	lit
occasionally	mod
offense	lit
offeree	lit
offerees	lit
offeror	lit
offerors	lit
often	mod
optionee	lit
optionees	lit
ordinarily	unc
ought	mod
outweighed	rev
overrule	lit
overruled	lit
overrules	lit
overruling	lit
para	lit
pari	lit
passu	lit
pecuniarily	lit
pending	unc
perhaps	mod
perjury	lit
permittee	lit
permittees	lit
perpetrate	lit
perpetrated	lit
perpetrates	lit
perpetrating	lit
perpetration	lit
personam	lit
petition	lit
petitioned	lit
petitioner	lit
petitioners	lit
petitioning	lit
petitions	lit
plaintiff	lit
plaintiffs	lit
pleading	lit
pleadings	lit
pleads	lit
pleas	lit
pledgee	lit
pledgees	lit
pledgor	lit
possessory	lit
possibilities	unc
possibility	unc
possible	mod
possibly	mod
postclosing	lit
postclosure	lit
postcontract	lit
postjudgment	lit
preamendment	lit
precaution	unc
precautionary	unc
precautions	unc
predecease	lit
predeceased	lit
predeceases	lit
predeceasing	lit
predict	unc
predictability	unc
predicted	unc
predicting	unc
prediction	unc
predictions	unc
predictive	unc
predictor	unc
predictors	unc
predicts	unc
prehearing	lit
prejudice	lit
prejudiced	lit
prejudices	lit
prejudicial	lit
prejudicing	lit
preliminarily	unc
preliminary	unc
prepetition	lit
presumably	unc
presume	unc
presumed	unc
presumes	unc
presuming	unc
presumption	unc
presumptions	unc
presumptively	lit
pretrial	lit
prima	lit
privity	lit
probabilistic	unc
probabilities	unc
probability	unc
probable	mod
probably	mod
probate	lit
probated	lit
probates	lit
probating	lit
probation	lit
probational	lit
probationary	lit
probationer	lit
probationers	lit
probations	lit
promulgate	lit
promulgated	lit
promulgates	lit
promulgating	lit
promulgation	lit
promulgations	lit
promulgator	lit
promulgators	lit
prorata	lit
proration	lit
prosecute	lit
prosecuted	lit
prosecutes	lit
prosecuting	lit
prosecution	lit
prosecutions	lit
prosecutor	lit
prosecutorial	lit
prosecutors	lit
proviso	lit
provisoes	lit
provisos	lit
punishable	lit
quitclaim	lit
quitclaims	lit
random	unc
randomize	unc
randomized	unc
randomizes	unc
randomizing	unc
randomly	unc
randomness	unc
rarely	mod
rata	lit
ratable	lit
ratably	lit
rather than	rev
reargument	lit
reassess	unc
reassessed	unc
reassesses	unc
reassessing	unc
reassessment	unc
reassessments	unc
rebut	lit
rebuts	lit
rebuttable	lit
rebuttably	lit
rebuttal	lit
rebuttals	lit
rebutted	lit
rebutting	lit
recalculate	unc
recalculated	unc
recalculates	unc
recalculating	unc
recalculation	unc
recalculations	unc
reconsider	unc
reconsidered	unc
reconsidering	unc
reconsiders	unc
recordation	lit
recoupable	lit
recoupment	lit
recoupments	lit
recourse	lit
recourses	lit
rectification	lit
rectifications	lit
recusal	lit
recuse	lit
recused	lit
recusing	lit
redact	lit
redacted	lit
redacting	lit
redaction	lit
redactions	lit
reexamination	unc
reexamine	unc
reexamining	unc
referenda	lit
referendum	lit
referendums	lit
refile	lit
refiled	lit
refiles	lit
refiling	lit
regularly	mod
regulate	lit
regulated	lit
regulates	lit
regulating	lit
regulation	lit
regulations	lit
regulative	lit
regulator	lit
regulators	lit
regulatory	lit
rehear	lit
reheard	lit
rehearing	lit
rehearings	lit
reinterpret	unc
reinterpretation	unc
reinterpretations	unc
reinterpreted	unc
reinterpreting	unc
reinterprets	unc
rejected	rev
releasees	lit
remand	lit
remanded	lit
remanding	lit
remands	lit
remediate	lit
remediated	lit
remediating	lit
remediation	lit
remediations	lit
remedied	lit
remised	lit
replevin	lit
requester	lit
requestor	lit
reregulation	lit
rescind	lit
rescinded	lit
rescinding	lit
rescinds	lit
rescission	lit
rescissions	lit
restitutionary	lit
retendering	lit
retrocede	lit
retroceded	lit
retrocessionaires	lit
reversal	rev
revise	unc
revised	unc
revocability	lit
revocation	lit
revocations	lit
risk	unc
risked	unc
riskier	unc
riskiest	unc
riskiness	unc
risking	unc
risks	unc
risky	unc
roughly	unc
rule out	rev
ruling	lit
rulings	lit
rumors	unc
seems	unc
seldom	mod
seldomly	mod
sentenced	lit
sentencing	lit
sequestrator	lit
settlement	lit
settlements	lit
severability	lit
severable	lit
severally	lit
severance	lit
severances	lit
shall	lit
should	mod
sometime	unc
sometimes	mod
somewhat	mod
somewhere	unc
speculate	unc
speculated	unc
speculates	unc
speculating	unc
speculation	unc
speculations	unc
speculative	unc
speculatively	unc
sporadic	unc
sporadically	unc
statute	lit
statutes	lit
statutorily	lit
statutory	lit
strongly	mod
subclause	lit
subclauses	lit
subleasee	lit
subleasehold	lit
sublessors	lit
sublicensee	lit
sublicensor	lit
subparagraph	lit
subparagraphs	lit
subpoena	lit
subpoenaed	lit
subpoenas	lit
subrogated	lit
subrogation	lit
subtrust	lit
subtrusts	lit
sudden	unc
suddenly	unc
sue	lit
sued	lit
sues	lit
suggest	mod
suggested	unc
suggesting	unc
suggests	mod
suing	lit
summoned	lit
summoning	lit
summons	lit
summonses	lit
supersede	lit
supersedeas	lit
superseded	lit
supersedes	lit
superseding	lit
sureties	lit
surety	lit
susceptibility	unc
tenantability	lit
tending	unc
tends	mod
tentative	unc
tentatively	unc
terminable	lit
terminus	lit
testamentary	lit
testify	lit
testifying	lit
testimony	lit
thence	lit
thenceforth	lit
thenceforward	lit
thereafter	lit
thereat	lit
therefrom	lit
therein	lit
thereinafter	lit
thereof	lit
thereon	lit
thereover	lit
thereto	lit
theretofor	lit
theretofore	lit
thereunder	lit
thereunto	lit
thereupon	lit
therewith	lit
tort	lit
tortious	lit
tortiously	lit
torts	lit
transferor	lit
turbulence	unc
unable	rev
unambiguously	mod
unappealable	lit
unappealed	lit
unauthorized	rev
unavailable	rev
unaware	rev
uncertain	mod
uncertainly	mod
uncertainties	unc
uncertainty	unc
unclear	unc
uncompromising	mod
unconfirmed	unc
unconstitutional	lit
unconstitutionality	lit
unconstitutionally	lit
uncontracted	lit
undecided	unc
undefined	unc
undesignated	unc
undetectable	unc
undeterminable	unc
undetermined	unc
undischarged	lit
undisputed	mod
undocumented	unc
undoubtedly	mod
unencumbered	lit
unenforceability	lit
unenforceable	lit
unequivocal	mod
unequivocally	mod
unexpected	unc
unexpectedly	unc
unfamiliar	unc
unfamiliarity	unc
unforecasted	unc
unforseen	unc
unguaranteed	unc
unhedged	unc
unidentifiable	unc
unidentified	unc
unknown	unc
unknowns	unc
unlawful	lit
unlawfully	lit
unlawfulness	lit
unobservable	unc
unparalleled	mod
unplanned	unc
unpredictability	unc
unpredictable	unc
unpredictably	unc
unpredicted	unc
unproved	unc
unproven	unc
unquantifiable	unc
unquantified	unc
unreconciled	unc
unremediated	lit
unseasonable	unc
unseasonably	unc
unsettled	unc
unspecific	unc
unspecified	unc
unstayed	lit
unsurpassed	mod
untested	unc
unto	lit
unusual	unc
unusually	unc
unwritten	unc
usually	mod
usurious	lit
usurp	lit
usurpation	lit
usurped	lit
usurping	lit
usurps	lit
usury	lit
vagaries	unc
variability	unc
variable	unc
variables	unc
variably	unc
variance	unc
variances	unc
variant	unc
variants	unc
variation	unc
variations	unc
varied	unc
varies	unc
vary	unc
varying	unc
vendee	lit
vendees	lit
verdict	lit
verdicts	lit
viatical	lit
violative	lit
voidable	lit
voided	lit
voiding	lit
volatile	unc
volatilities	unc
volatility	unc
warrantees	lit
warrantor	lit
was n't	rev
was no	rev
was not	rev
whatever	lit
whatsoever	lit
whensoever	lit
whereabouts	lit
whereas	lit
whereat	lit
whereby	lit
wherefore	lit
wherein	lit
whereof	lit
whereon	lit
whereto	lit
whereunder	lit
whereupon	lit
wherewith	lit
whistleblowers	lit
whomever	lit
whomsoever	lit
whosoever	lit
wilful	lit
will	mod
will not	rev
will not be	rev
willful	lit
willfully	lit
willfulness	lit
with the exception of	rev
without	rev
witness	lit
witnesses	lit
wo n't be	rev
won't	rev
would	mod
would not	rev
would not be	rev
writ	lit
writs	lit
